1 0 0 1 0 0 1
0 0 0 0 0 0 0
0 0 0 0 0 0 0
1 0 0 0 0 0 1
0 0 s s 0 0 0
0 0 s s 0 0 0
2 s s s s s 1
1 0 0 0 0 0 1
0 1 0 1 0 1 0